NO 			   	./assets/wood.xpm
SO 						                  ./assets/eagle.xpm
WE                      		./assets/greystone.xpm
EA 										                    ./assets/bluestone.xpm
F 100		,   50    ,        100
C 255	,255	,			255

        1111111111111111111111111
       100000000000000000000000001
       100000000000000000000000001
        1111111111111111111111111
        1000000000000000000000001
        1100000000000000000000001   11111
        1000000000000000000000001   110N1
111111111000000000000000000000001   11111
100000000000000000000000000001111
10000000000000000000000000001
10000000000000000000000000001
10000000000000000000000000001
10000000000000000000000000001
10000000000000000001010000001
11000001110101011111011110101
11110111 1110111 101111010001
11111111 1111111 111111111111
