NO ../assets/wood.xpm
SO ../assets/eagle.xpm
WE ../assets/greystone.xpm
EA ../assets/bluestone.xpm
F 110,153,15
C 255,255,255

111111N11111
