NO ../assets/wood.xpm
SO ../assets/eagle.xpm
WE ../assets/greystone.xpm
EA ../assets/bluestone.xpm
FF 100,153,15
C 255,255,255

        1111111111111111111111111
        1000000000000000000000001
        11000000000000000N0000001
        1000000000000000000000001
111111111000000000000000000000001
100000000000000000000000000001111
10000000000000000000000000001
10000000000000000000000000001
10000000000000000000000000001
10000000000000000000000000001
10000000000000000001010000001
11000001110101011111011110101
11110111 1110111 101111010001
11111111 1111111 111111111111
