NO ../assets/wood.xpm
SO ../assets/eagle.xpm
WE ../assets/greystone.xpm
EA ../assets/bluestone.xpm
F 1100,153,15
C 255,255,255

11111111111111111111111111111111111111111111111111111111111111111111111111111111111110N01111111111111111111111111111111111111111111111111111111111111111111111111111111111111111111111111111111111111111111111111111111111111111111111111111111111111111111111111111111111111111111111111111111111111111111111111111111111111111111111100011111111111111111111111111111111111111111111111111111111111111111111111111111111111111111111111
